NO ./textures/wall_1.xpm
SO ./textures/wall_2.xpm
WE ./textures/wood.xpm
EA ./textures/3.xpm
F 61,15,15
C 30,140,162

1111111111111111111111111
1000000000110000000000001
1011000001110000000000001

1001000000000000000000001
1111111110110000011100001
1000000000110000011101111
1111011111111101110000001
1111011111111101110101001
1100000011010101110000001111111
1000000000000000110000000000N01
1000000000000000110101001111111
1110000111010101111101111
1111111111111111111111111
